0 0 0 0 0 0 0 0 0 0
0 0 0 0 0 0 0 0 0 0
2 2 2 2 2 2 2 2 2 2 
2 2 2 2 2 2 2 2 2 2
5 5 5 5 5 5 5 5 5 5
5 5 5 5 5 5 5 5 5 5
3 3 3 3 3 3 3 3 3 3 
3 3 3 3 3 3 3 3 3 3 
4 4 4 4 4 4 4 4 4 4 
4 4 4 4 4 4 4 4 4 4
0 0 0 0 0 0 0 0 0 0
0 0 0 0 0 0 0 0 0 0
0 0 0 0 0 0 0 0 0 0
0 0 0 0 0 0 0 0 0 0
0 0 0 0 0 0 0 0 0 0
0 0 0 0 0 0 0 0 0 0